S ./textures/pillar.xpm
H ./textures/health.xpm
NO ./textures/north.xpm
SO ./textures/south.xpm
WE ./textures/west.xpm
EA 	./textures/east.xpm
R 1000 1000
F 220,100,0
C 225,30,0;

11111111111111111111111111111111
10000010000000100001000001000001
10102010201020100000000E00000011
10100000001000000010000000100001
10100000001000000010000000100001
10100000001000000010000000100001
10100000001000000010000000100001
10100000001000000010000000100001
11111111111111111111111111111111